00000000000000000000000000000000000000000000000000000000000000000000000000000000000000000000000000000000000000000000000000000000000000000000000000000
0                                                                                                                                                   0
0                                                                                                                                                   0
0                                                                                                                                                   0
0                                                                                                                                                   0
0                   C                                              M            C                                                                   0
0      C                                             C        M   M M                                           C                                   0
0                                                        M                                                        C                                 0
0                                   C               M             BBB                                               C                               0
0                                                            BBB                          MMM                                                       0
0                                                       BBB                            M                                                            0
0                                             K  V BBB                                     B                                                        0
0                                             BBB                          M           M  BBB                                                       0
0               T  M                     BBB                              MMM         M  BBBBB                                                      0
0                                                                                       BBBBBBB                                                     0
0          K  V   H   A             H                                                  BBBBBBBBB                     MMMMMMMMMMMMMMMMMMMMM          0
BBBBBBBBBBBBBBBBBBBBBBBBBBBBBBBBBBBBBBBBBBBBBBBBBBBBBBBBBBBBBBBBBBBBBBBBBBBBBBBBBBBBBBBBBBBBBBBBBBBBBBBBBBBBBBBBBBBBBBBBBBBBBBBBBBBBBBBBBBBBBBBBBBBBB
BBBBBBBBBBBBBBBBBBBBBBBBBBBBBBBBBBBBBBBBBBBBBBBBBBBBBBBBBBBBBBBBBBBBBBBBBBBBBBBBBBBBBBBBBBBBBBBBBBBBBBBBBBBBBBBBBBBBBBBBBBBBBBBBBBBBBBBBBBBBBBBBBBBBB
BBBBBBBBBBBBBBBBBBBBBBBBBBBBBBBBBBBBBBBBBBBBBBBBBBBBBBBBBBBBBBBBBBBBBBBBBBBBBBBBBBBBBBBBBBBBBBBBBBBBBBBBBBBBBBBBBBBBBBBBBBBBBBBBBBBBBBBBBBBBBBBBBBBBB